{
	"spritesheet":"terrain_atlas",
	"tileSize": 32,

	"width": 64,
	"height": 64,

	"layers": [
		{
			"isVisible": true,
			"tiles":[0,119,119,119,119,119,119,119,119,119,119,119,119,119,119,119,119,119,119,119,119,119,119,119,119,119,119,119,119,119,119,119,119,119,119,119,119,119,119,119,119,119,119,119,119,119,119,119,119,119,119,119,119,119,119,119,119,119,119,119,119,119,119,119,
					119,119,119,119,119,119,119,119,119,681,682,682,682,683,119,119,119,119,119,119,119,119,119,119,119,119,119,119,119,119,119,119,119,119,119,119,119,119,119,119,119,119,119,119,119,119,119,119,113,113,113,113,113,119,119,119,119,119,119,119,119,119,119,119,
					119,119,119,119,119,119,119,119,119,713,714,714,652,716,682,682,683,119,119,119,119,119,119,119,119,119,119,119,119,119,119,119,119,119,119,119,119,119,119,119,119,119,119,119,119,119,119,113,113,113,113,113,113,113,113,119,119,119,119,119,119,119,119,119,
					119,119,119,119,119,119,119,119,119,713,714,652,650,714,714,714,716,119,119,119,119,119,119,119,119,119,119,119,119,119,119,119,119,119,119,119,119,119,119,119,119,119,119,119,119,119,119,113,113,113,113,113,113,113,113,113,113,119,119,119,119,119,119,119,
					119,119,119,119,119,119,119,119,119,713,714,652,652,650,714,714,714,119,119,119,119,119,119,119,119,119,119,119,119,119,119,119,119,119,119,119,119,119,119,119,119,119,119,119,119,119,113,113,113,933,933,933,933,933,933,113,113,113,113,119,119,119,119,119,
					119,119,119,119,119,119,119,119,119,713,714,714,650,650,714,714,714,119,119,119,119,119,119,119,119,119,119,119,119,119,119,119,119,119,119,119,119,119,119,119,119,119,119,119,119,113,113,113,113,933,933,933,933,933,933,933,113,113,113,113,119,119,119,119,
					119,119,119,119,119,119,119,119,119,713,714,714,714,714,714,119,119,119,119,119,119,119,119,119,119,119,119,119,119,119,119,119,119,119,119,119,119,119,119,119,119,119,119,119,119,113,113,113,113,933,933,933,933,933,933,933,113,113,113,113,113,119,119,119,
					119,119,119,119,184,119,119,119,119,713,714,714,714,714,714,119,119,119,119,119,119,119,119,119,119,119,119,119,119,119,119,119,119,119,119,119,119,119,119,119,119,119,119,119,119,113,113,113,113,933,933,933,933,933,933,933,113,113,113,113,113,113,119,119,
					119,119,119,119,119,119,119,119,713,714,714,714,714,714,714,119,119,119,119,119,119,119,119,119,119,119,119,119,119,119,119,119,119,119,119,119,119,119,119,119,119,119,183,119,119,113,113,113,113,933,933,933,933,933,933,933,113,113,113,113,113,113,119,119,
					119,119,119,119,119,119,119,119,713,649,650,650,714,714,714,119,119,119,119,119,119,119,119,119,119,119,119,119,119,119,119,119,119,119,119,119,119,119,119,119,119,119,119,119,119,113,113,113,113,933,933,933,933,933,933,933,113,113,113,113,113,119,119,119,
					119,119,119,119,119,119,119,119,713,714,650,650,650,714,714,119,119,119,119,119,119,119,119,119,119,119,119,119,119,119,119,119,119,119,119,119,119,119,119,119,119,119,119,119,113,113,113,113,933,933,933,933,933,933,933,933,113,113,113,113,113,119,119,119,
					119,119,119,119,119,119,119,119,119,714,714,714,714,714,714,119,119,119,119,119,119,119,119,119,119,119,119,119,119,119,119,119,119,119,119,119,119,119,119,119,119,119,119,119,113,113,113,113,933,933,933,933,933,933,933,113,113,113,113,113,113,119,119,119,
					119,119,119,119,119,119,119,119,119,119,714,714,714,714,119,119,119,119,119,119,183,119,119,119,119,119,119,119,119,119,119,119,119,119,119,119,119,119,119,119,119,119,119,119,119,113,113,113,113,933,933,933,933,933,933,113,113,113,113,113,119,119,119,119,
					119,119,119,119,119,119,119,119,119,119,119,119,119,119,119,119,119,119,119,119,119,119,119,119,119,119,119,119,119,119,119,119,119,119,119,119,119,119,119,119,119,119,119,119,119,119,113,113,113,113,113,933,933,933,113,113,113,113,113,119,119,119,119,119,
					119,119,119,119,119,184,119,119,119,119,119,119,119,119,119,119,119,119,119,119,119,119,119,119,119,119,119,119,119,119,119,119,119,119,119,119,119,119,119,119,119,119,119,119,119,119,119,119,113,113,113,113,113,113,113,113,113,113,113,119,119,119,119,119,
					119,119,119,119,119,119,119,119,119,119,119,119,119,119,119,119,119,119,119,119,119,119,119,119,119,119,119,119,119,119,119,119,119,119,119,119,119,119,119,119,119,119,119,119,119,119,119,119,119,119,119,113,113,113,113,113,119,119,119,119,119,119,119,119,
					119,119,119,119,119,119,119,184,119,119,119,119,119,119,119,119,119,119,119,119,119,119,119,119,119,119,119,119,119,119,119,119,119,119,119,119,119,119,119,119,119,119,119,119,119,119,119,119,119,119,119,119,119,119,119,119,119,119,119,119,119,119,119,119,
					119,119,119,119,119,119,119,119,184,119,119,119,119,119,119,119,119,119,119,119,119,119,119,119,119,119,119,119,119,119,119,119,119,119,119,119,119,119,119,119,119,119,119,119,119,119,119,119,119,119,119,119,119,119,119,119,119,119,119,119,119,119,119,119,
					119,119,119,119,119,119,119,119,119,119,119,119,119,119,119,119,119,119,119,119,119,119,119,119,119,119,119,119,119,119,119,119,119,119,119,119,119,119,119,327,119,119,119,119,119,119,119,119,119,119,119,119,119,119,119,119,119,119,119,119,119,119,119,119,
					119,119,119,119,119,119,119,119,119,119,119,119,119,119,119,119,119,119,119,119,119,119,119,119,119,119,119,119,119,119,119,119,119,119,119,119,119,119,119,119,119,119,119,119,119,119,119,119,119,119,119,119,119,119,119,119,119,119,119,119,119,119,119,119,
					119,119,119,119,119,119,119,119,119,119,119,119,119,119,119,119,119,119,119,119,119,119,119,119,119,119,119,119,119,119,119,119,119,119,119,119,119,119,119,119,119,119,119,119,119,119,182,119,119,119,119,119,119,119,119,119,119,119,119,119,119,119,119,119,
					119,119,119,119,119,119,119,119,119,119,119,119,119,119,119,119,119,119,119,119,119,119,119,119,119,119,119,119,119,119,119,119,119,119,119,119,119,119,119,119,119,119,119,119,119,119,119,119,119,119,119,119,119,119,119,119,119,119,119,119,119,119,119,119,
					119,119,119,119,119,119,119,119,119,119,119,119,119,119,119,119,119,119,119,119,119,119,119,119,119,119,119,119,375,119,119,119,119,119,119,119,119,119,119,119,183,119,119,119,119,119,119,119,119,119,119,119,119,119,119,119,119,119,119,182,119,119,119,119,
					119,119,119,119,119,184,948,1010,1010,1010,1010,1010,1010,1010,1010,949,119,119,119,119,119,119,119,119,119,119,119,119,119,119,119,119,119,119,119,375,119,119,119,119,119,119,119,119,119,119,119,119,119,119,119,119,119,119,119,119,119,119,119,119,119,119,119,119,
					119,119,119,119,119,119,979,727,727,727,727,727,727,727,727,977,119,119,119,119,119,119,119,119,119,119,119,119,119,119,119,119,119,119,119,119,119,119,119,119,119,119,119,119,119,119,119,119,119,119,119,119,119,119,119,183,119,119,119,119,119,119,119,119,
					119,119,119,119,119,119,979,727,727,727,727,727,727,727,727,977,119,119,119,119,119,119,119,119,119,119,386,386,386,386,386,386,119,119,119,119,119,119,376,119,119,119,119,119,119,119,119,119,119,119,119,119,119,119,119,119,119,119,119,119,119,119,119,119,
					119,119,119,119,119,119,979,727,727,727,727,727,727,727,727,977,119,119,119,119,119,119,119,119,386,386,386,386,386,386,386,386,386,386,386,386,119,119,119,119,119,119,119,119,119,119,119,119,119,119,119,119,119,119,119,119,119,119,119,119,119,119,119,119,
					119,119,119,119,119,119,979,727,727,727,727,727,727,727,727,977,119,119,119,119,119,119,119,386,389,389,389,389,389,389,389,389,389,389,386,386,386,386,119,119,375,119,119,119,119,119,119,119,119,119,119,119,119,119,119,119,119,119,119,119,119,119,119,119,
					119,119,119,119,119,119,979,727,730,727,727,727,727,730,727,977,119,119,119,119,119,386,386,389,386,386,386,386,386,386,386,386,386,386,386,389,389,386,386,119,119,119,119,119,119,119,119,119,119,119,119,119,119,119,119,119,119,119,119,119,119,119,119,119,
					119,119,119,119,119,119,979,727,727,727,727,727,727,727,727,977,119,119,119,119,386,386,389,386,386,392,395,395,395,395,395,395,395,392,386,386,389,389,386,386,119,119,119,119,119,119,119,119,119,119,119,119,119,119,119,119,183,119,119,119,119,119,119,119,
					119,119,119,119,119,119,980,946,946,946,946,946,946,946,946,981,119,119,119,119,386,389,389,386,392,395,395,395,395,395,395,395,395,395,395,392,386,389,386,386,119,119,119,119,119,119,119,119,119,119,119,119,119,119,119,119,119,119,119,119,119,119,119,119,
					119,119,119,119,119,119,119,119,119,119,119,119,119,119,119,119,119,119,119,386,386,389,386,392,395,395,395,296,424,424,297,395,395,395,395,395,386,389,389,386,119,119,119,119,119,119,119,119,119,119,119,119,119,119,119,119,119,119,119,119,119,119,119,119,
					119,119,119,119,119,119,119,119,119,119,119,119,119,119,119,119,119,119,119,386,386,389,386,395,395,395,395,393,183,182,423,297,395,395,395,395,392,386,389,386,386,119,119,119,119,119,119,119,119,119,119,119,119,182,119,119,119,119,119,119,119,119,119,119,
					119,119,119,119,119,119,119,119,119,119,119,119,119,119,119,375,119,119,119,386,386,389,386,395,395,395,395,393,119,119,184,391,395,395,395,395,395,386,389,386,386,119,182,119,119,119,119,119,119,119,119,119,119,119,119,119,119,119,119,119,119,119,119,119,
					119,119,119,119,119,119,119,119,119,119,119,119,119,119,119,119,119,119,119,386,386,389,386,395,395,395,395,393,184,119,119,391,395,395,395,395,395,386,389,386,386,119,119,119,119,119,119,119,119,119,119,119,119,119,119,119,119,119,119,119,119,119,119,119,
					119,119,119,119,119,119,119,119,119,119,119,119,119,119,119,119,119,119,119,386,386,389,386,392,395,395,395,328,360,360,360,329,395,395,395,395,395,386,389,386,386,119,119,119,119,119,119,119,119,119,119,119,119,119,119,119,119,119,119,119,119,119,119,119,
					119,119,119,119,119,119,119,119,119,119,119,119,119,119,119,119,119,119,119,386,386,389,386,395,395,395,296,297,395,395,395,395,395,395,395,395,395,386,389,386,386,119,119,119,119,119,119,119,119,119,119,119,119,119,119,119,119,119,119,119,119,119,119,119,
					119,119,119,119,119,119,119,119,119,119,119,119,119,119,327,119,119,119,119,119,386,389,386,392,395,395,328,329,395,395,395,395,395,395,395,395,395,386,389,386,119,119,375,119,119,119,119,119,119,119,119,119,119,119,119,119,182,119,119,119,119,119,119,119,
					119,119,119,119,119,119,119,374,119,119,119,119,182,119,119,119,119,119,119,119,386,389,389,386,392,395,395,395,296,424,297,395,395,395,392,392,386,386,389,386,119,119,119,119,119,119,119,119,119,119,119,119,119,119,119,119,119,119,119,119,119,119,119,119,
					119,119,119,119,119,119,119,119,119,119,119,119,119,119,119,119,119,119,119,119,386,386,389,389,386,395,395,395,393,119,391,395,395,395,392,386,389,389,389,119,119,119,119,119,119,119,119,119,119,119,119,119,119,119,119,119,119,119,119,119,119,119,119,119,
					119,119,119,119,119,119,119,119,119,119,119,374,119,119,119,119,119,119,119,119,119,386,386,389,386,386,392,395,328,360,329,395,392,392,386,389,389,389,386,119,119,119,295,119,119,119,119,119,119,119,119,119,119,119,119,119,119,119,119,119,119,119,119,119,
					119,119,119,119,119,119,119,119,119,119,119,119,183,119,119,119,119,119,119,119,119,119,386,386,389,389,386,392,392,395,395,392,386,389,389,389,389,389,119,119,119,119,119,119,119,119,119,119,119,119,119,119,119,119,119,119,119,119,119,119,119,119,119,119,
					119,119,119,119,119,119,119,119,119,119,119,119,119,119,119,119,119,119,119,119,119,119,119,386,386,389,389,386,386,386,386,386,389,389,389,389,389,119,119,119,375,119,119,119,182,119,119,119,119,119,119,119,119,119,119,119,119,119,119,119,119,119,119,119,
					119,119,119,119,119,119,119,119,119,119,119,119,119,119,119,119,119,119,119,119,119,119,119,119,386,386,389,389,389,389,389,389,389,389,389,119,119,119,119,119,119,119,119,119,119,119,119,119,119,119,119,119,119,119,119,119,119,119,119,119,119,119,119,119,
					119,119,119,119,119,119,119,119,119,119,119,119,119,119,119,119,119,119,119,119,119,119,119,119,119,386,386,386,386,389,389,389,389,389,119,119,374,119,119,119,119,119,119,119,119,119,119,119,119,119,119,119,119,119,119,119,119,119,119,119,119,119,119,119,
					119,119,119,119,119,119,119,119,119,119,119,119,119,119,119,119,119,119,119,119,119,119,119,119,119,119,119,119,119,119,119,119,119,119,119,119,119,119,119,182,119,119,119,119,119,119,119,119,119,119,119,119,119,119,119,119,119,119,119,119,119,119,119,119,
					119,119,119,119,119,119,119,119,119,119,119,183,376,119,119,119,119,119,119,119,119,119,119,119,119,119,119,119,119,119,119,376,119,119,119,119,119,119,119,119,119,119,119,119,119,119,119,119,119,119,119,119,119,119,119,119,119,119,119,119,119,119,119,119,
					119,119,119,119,119,119,119,119,119,119,119,119,119,119,119,119,119,119,119,119,119,119,119,119,119,119,119,119,119,119,119,119,119,119,119,119,119,119,119,119,119,119,119,119,119,119,119,119,119,119,119,119,119,119,119,119,119,119,119,119,119,119,119,119,
					119,119,119,119,119,119,119,119,119,119,119,119,119,119,119,119,119,119,119,119,119,119,119,119,119,119,119,119,119,119,119,119,119,119,119,119,119,119,119,119,119,119,119,119,119,119,119,119,119,119,119,119,119,119,119,119,119,119,119,119,119,119,119,119,
					119,119,119,119,119,119,119,119,119,119,119,119,119,119,119,119,119,119,119,119,119,119,119,119,119,376,119,119,119,119,119,119,119,119,119,119,119,119,119,119,119,119,119,119,119,119,119,119,119,119,119,119,119,119,119,119,119,119,119,119,119,119,119,119,
					119,119,119,119,119,119,119,119,119,119,119,119,119,119,119,119,119,119,119,119,119,119,119,119,119,119,119,119,119,119,119,119,119,119,119,119,119,119,119,119,119,119,119,119,119,119,119,119,119,119,119,119,119,119,119,119,119,119,119,119,119,119,119,119,
					119,119,119,119,119,119,119,119,119,119,119,119,374,119,119,119,119,119,376,119,119,119,119,119,119,119,119,119,119,119,119,119,119,119,119,119,119,119,119,119,119,119,119,119,119,119,119,119,119,119,119,119,119,119,119,119,119,119,119,119,119,119,119,119,
					119,119,119,119,119,119,119,119,119,119,119,119,119,119,119,119,119,119,119,119,119,119,119,119,119,119,119,119,119,119,119,119,119,119,119,376,119,119,119,119,119,119,119,119,119,119,119,119,119,119,803,119,119,119,119,119,119,119,119,119,119,119,119,119,
					119,119,119,119,119,119,119,119,119,119,119,119,119,119,119,119,119,119,119,119,119,119,119,119,119,119,119,119,119,119,119,119,119,119,119,119,119,119,119,119,119,119,119,119,119,119,119,119,119,119,119,119,119,119,119,119,119,119,119,119,119,119,119,119,
					119,119,119,119,119,119,119,119,119,119,119,119,119,119,119,119,119,119,119,119,119,119,119,119,119,119,119,119,119,119,119,119,119,119,119,119,119,119,119,119,119,119,119,119,119,119,119,119,119,119,119,119,119,119,119,119,119,119,119,119,119,119,119,119,
					119,119,119,119,119,119,119,119,119,119,119,119,119,119,119,119,119,119,183,119,119,119,119,119,119,119,119,119,119,119,119,119,119,119,119,119,119,119,119,119,119,119,119,119,119,119,119,119,119,119,119,119,119,119,119,119,119,119,119,119,119,119,119,119,
					119,119,119,119,119,119,119,119,119,119,119,119,119,119,119,119,119,119,119,119,119,119,119,119,119,119,119,119,119,119,119,119,119,119,119,119,119,119,119,119,119,119,119,119,119,119,119,119,119,119,119,119,119,119,119,119,119,119,119,119,119,119,119,119,
					119,119,119,119,119,119,119,119,119,119,119,119,119,119,119,119,119,119,119,119,119,119,119,119,119,119,119,119,119,119,119,119,119,119,119,119,119,119,119,119,183,119,119,119,119,119,119,119,119,119,119,119,119,119,119,119,119,119,119,119,119,119,802,119,
					119,119,119,119,119,119,119,119,119,119,119,119,119,119,119,119,119,119,119,119,119,119,119,119,184,119,119,119,119,119,119,119,119,119,119,119,119,119,119,119,119,119,119,119,119,119,119,119,119,119,119,119,119,119,119,119,119,119,119,119,183,119,119,119,
					119,119,119,119,119,119,119,119,119,119,119,119,119,119,119,119,119,119,119,119,119,119,119,119,119,119,119,119,119,183,119,119,119,119,119,119,119,119,119,119,119,119,119,119,119,119,119,119,119,119,119,119,119,119,119,119,119,119,119,119,119,119,119,119,
					119,119,119,119,119,119,119,119,183,119,119,119,119,119,119,119,119,119,119,119,119,119,119,119,119,119,119,119,119,119,119,119,119,119,119,119,119,119,119,119,119,119,119,119,119,119,803,119,119,119,119,119,119,119,119,119,119,119,119,119,119,119,119,119,
					119,119,119,119,119,119,119,119,119,119,119,119,119,119,119,119,119,119,119,119,119,119,119,119,119,119,119,119,119,119,119,119,119,119,119,119,119,119,119,119,119,119,119,119,119,119,119,119,119,119,119,119,119,119,119,119,119,119,119,119,802,119,119,119,
					119,119,119,119,119,119,119,119,119,119,119,119,119,119,119,119,119,119,119,119,119,119,119,119,119,119,119,119,119,119,119,119,119,119,119,119,119,119,119,119,119,119,119,184,119,119,119,119,119,119,119,119,119,119,119,119,119,119,119,119,119,119,119,119,
					119,119,119,119,119,119,119,119,119,119,119,119,119,119,119,119,119,119,119,119,119,119,119,119,119,119,119,119,119,119,119,119,119,119,119,119,119,119,119,119,119,119,119,119,119,119,119,119,119,119,119,119,119,119,119,119,119,119,119,119,119,119,119,119]		
		}
	],

	//Rectangles for collision
	"collisionObjects":[
		{
            "@id": 207,
            "@x": 800,
            "@y": 928,
            "@width": 288,
            "@height": 32
        },
        {
            "@id": 208,
            "@x": 768,
            "@y": 960,
            "@width": 384,
            "@height": 32
        },
        {
            "@id": 209,
            "@x": 736,
            "@y": 992,
            "@width": 416,
            "@height": 32
        },
        {
            "@id": 210,
            "@x": 736,
            "@y": 1024,
            "@width": 448,
            "@height": 32
        },
        {
            "@id": 211,
            "@x": 736,
            "@y": 1056,
            "@width": 448,
            "@height": 32
        },
        {
            "@id": 212,
            "@x": 736,
            "@y": 1088,
            "@width": 448,
            "@height": 32
        },
        {
            "@id": 213,
            "@x": 736,
            "@y": 1120,
            "@width": 448,
            "@height": 32
        },
        {
            "@id": 214,
            "@x": 736,
            "@y": 1152,
            "@width": 448,
            "@height": 32
        },
        {
            "@id": 215,
            "@x": 736,
            "@y": 1184,
            "@width": 448,
            "@height": 32
        },
        {
            "@id": 216,
            "@x": 768,
            "@y": 1216,
            "@width": 384,
            "@height": 32
        },
        {
            "@id": 217,
            "@x": 800,
            "@y": 1248,
            "@width": 320,
            "@height": 32
        },
        {
            "@id": 218,
            "@x": 832,
            "@y": 1280,
            "@width": 256,
            "@height": 32
        },
        {
            "@id": 219,
            "@x": 864,
            "@y": 1312,
            "@width": 160,
            "@height": 32
        }
	]
}